17 32                  
##################     #########
#             $                #
#                              #
#               #              #
########        #        $    00000
#               #              #
#               #####          #
#      $        #              #
#               #              #
#               #              #
#            ########          #
#                              #
#####       $             $    #
#                              #
#                              #
#                              #
########    ####################
