8 12 1 2 8 2
# ##########
# ####     #
# ###  ### #
# ### ##   #
#     ###  #
########   #
#          #
# ##########
